NO ./textures/back_rooms/text 2.xpm
SO ./textures/back_rooms////////text 2.xpm
WE ./textures/back_rooms/text 2.xpm
EA ./textures/back_rooms/text 2.xpm

F 0,0,0
C 0,0,0

111111111111111111111111111111
1E0000001000000000100000000001
101111101011111110101111111101
100000001000001000100000001001
111011111111101011111101101101
100010000000001000000001000001
101110111111111011111111111101
100010000100000010000000000001
101011111101111110111111111101
100010000001000000100000001001
111110111111011111101111101101
100000100000010000000001000001
101111101111111111111101111101
100000001000000010000000001001
101111111011111111111111101101
100000000010000000000000000001
101111111111101111111111111101
100000000000100000000000000001
101111111111111111111111111101
111111111111111111111111111111
