NO ./textures/minecratft_museum/minecraft_paint1.xpm
SO ./textures/minecratft_museum/minecraft_paint2.xpm
WE ./textures/minecratft_museum/minecraft_paint3.xpm
EA ./textures/minecratft_museum/creeper2.xpm


F 255,255,255
C 32,6,45


111111111111111111111111111111
1N0000000000000000000000000001
101111111011111011111011111101
101000001010001010001010000001
101011101011101011101011101101
101010001000001000001000001001
101010111111111111111111101101
101010100000000000000000101001
101010101111111011111110101101
100010101000001010000010101001
111010101011101010111010111101
100010100010001000100010000001
101110111110111101111011111101
100000100000000000000010000001
101111101111111111111110111101
100000001000000000000000000001
111111101011111111111111101111
100000101000000000000000101001
101111101111111111111111101101
111111111111111111111111111111
