
NO ./textures/gnawa/zelijv2.xpm
SO ./textures/gnawa/wall2_pixel.xpm
WE ./textures/gnawa/zelijv1.xpm
EA ./textures/gnawa/textured_wall.xpm

F 220,100,22
C 225,30,1

11111111111111111111111111111111111
10000000000000000000000000000000001
10111111111111111111111111111111001
10100000000000000000000000000001001
10101111111111111111111111111001001
10101000000000000000000000001001001
10101011111111111111111111001001001
10101010000000000000000001001001001
10101010111111111111111001001001001
10101010100000000000001001001001001
10101010101111111111101001001001001
10101010101000000000101001001001001
10101010101011111110101001001001001
10101010101010000010101001001001001
10101010101010111010101001001001001
10101010101010001010101001001001001
10101010101010101010101001001001001
10101010101010101010101001001001001
10101010001000101010001001001001001
10101110111010101010111001001001001
10100000000010100000100001001001001
10111111111110111111111111001001001
10000000000010100000000000001001001
10111111111010101111111111111001001
10000000001000000000000000000001001
10111111101111111111111111111111001
10000000000000000000000000000000001
10111111111111111111111111111111101
1S000000000000000000000000000000001
11111111111111111111111111111111111

































































































































































































































