
NO ./textures/gnawa/zelijv2.xpm
SO ./textures/gnawa/wall2_pixel.xpm
WE ./textures/gnawa/zelijv1.xpm
EA ./textures/gnawa/textured_wall.xpm

F 220,100,22
C 225,30,1

11111111111111111111111111111111111
10000000000000000000000000000000001
10111111111111111111111111111111001
10100000000000000000000000000001001
10101011111111111101111111111001001
10101000N00000000000000000001001001
10101011111111111111111111001001001
10101010000000000000000001001001001
10101010111111111111111001001001001
11111111111111111111111111111111111

























































































































