

F     220,100,22,,,,,,,,,,,,
C 225,30,1

    NO ./textures/gnawa/bab.xpm
SO ./textures/gnawa/wall2_pixel.xpm
WE ./textures/gnawa/door.xpm
EA ./textures/gnawa/bab.xpm


                    111111111111111111111111111111111
                    100000000011000000000000111111111
                     11110000111111111111111111111111
111111111111111111111000000000001
100000000011000001110111111111111
111101111111110111000000100011111
111101111111110111010100100011111
110000001101010111000000100011111
11000000110101011100000S0100011111
110000001101010111000000100011111
110000001101010111000000100011111
110000001101010111000000100011111
110000001101010111000000100011111
110000001101010111111111111111111
111111111111111111111111111111111

































































































































































































































