NO ./textures/bcs/ad.xpm
SO ./textures/bcs/ad2.xpm
WE ./textures/bcs/jimiiii.xpm
EA ./textures/bcs/mikiii.xpm

F 26,44,117
C 32,6,45

111111111111111111111
1111111111E0000000001
10000000000000000000111111111111111111
10000000000000000000111111111111111111
10000000000000000000111111111111111111
10000000000000000000111111111111111111
10000000000000000000111111111111111111
10000000000000000000111111111111111111
10000000000000000000111111111111111111
10000000000000000000111111111111111111
10000000000000000000111111111111111111
10000000000000000000111111111111111111
10000000000000000000111111111111111111
10000000000000000000111111111111111111
10000000000000000000111111111111111111
10000000000000000000111111111111111111
10000000000000000000111111111111111111
10000000000000000000111111111111111111
11111111111110000000000000000000111111111111111111
10000000000000000000111111111111111111
10000000000000000000000000000000000001
10000000000000000000000000000000000001
10000000000000000000000000000000000001
10000000000000000000000000000000000001
10000000000000000000000000000000000001
10000000000000000000000000000000000001
1000000000000000000000000000000000000111111111111111111111111
1000000000000000000000000000000000000000000000000000000000001
1000000000000000000000000000000000000111111111111111100000001
1000000000000000000000000000000000000111111111111111100000001
1000000000000000000000000000000000000100000000000000000000001
1000000000000000000000000000000000000100000000000000000000001
1000000000000000000000000000000000000100000000000000000000001
111111111110011111111111111111111111111111111111111111111111111111111111111111111111
111111111110000000001
10000000000000000000111111111111111111
10000000000000000000111111111111111111
10000000000000000000111111111111111111
10000000000000000000111111111111111111
10000000000000000000111111111111111111
10000000000000000000111111111111111111
10000000000000000000111111111111111111
10000000000000000000111111111111111111
10000000000000000000111111111111111111
10000000000000000000111111111111111111
10000000000000000000111111111111111111
10000000000000000000111111111111111111
10000000000000000000111111111111111111
10000000000000000000111111111111111111
10000000000000000000111111111111111111
10000000000000000000111111111111111111
10000000000000000000111111111111111111
10000000000000000000111111111111111111
10000000000000000000000000000000000001
10000000000000000000000000000000000001
10000000000000000000000000000000000001
10000000000000000000000000000000000001
10000000000000000000000000000000000001
10000000000000000000000000000000000001
1000000000000000000000000000000000000111111111111111111111111
1000000000000000000000000000000000000000000000000000000000001
1000000000000000000000000000000000000111111111111111100000001
1000000000000000000000000000000000000111111111111111100000001
1000000000000000000000000000000000000100000000000000000000001
1000000000000000000000000000000000000100000000000000000000001
1000000000000000000000000000000000000100000000000000000000001
1111111111111111111111111111111111111111111111111111111111111