
NO ./textures/bcs/ad2.xpm       
SO ./textures/bcs/ad2.xpm
WE ./textures/bcs/jimiiii.xpm
EA ./textures/bcs/mikiii.xpm

F 26,44,117
C 32,6,45,

111111111111111111111
1111111111N0000000001
111111111111111111111