NO ./textures/gnawa/bab.xpm
SO ./textures/gnawa/wall2_pixel.xpm
WE ./textures/gnawa/door.xpm
EA ./textures/gnawa/bab.xpm

F 220,100,22
C 225,30,1

111111111111111111111111111111111
100000000011000000000000111111111
111110000111000000000000111111111
100100000000000000000000111111111
111111111011000001110000000000001
100000000011000001110111111111111
111101111111110111000000100011111
111101111111110111010100100011111
110000001101010111000000100011111
100000000000000011000000100011111
1000000000W0000011010100100011111
110000011101010111110111100111111
111101111111011111011110100011111
111111111111111111111111111111111
