NO ./textures/wolfstein/wall_hitler.xpm
WE ./textures/wolfstein/wall_hitler.xpm
SO ./textures/wolfstein/wall_hitler.xpm
EA ./textures/wolfstein/wall_ww2.xpm

F 0,0,0
C 32,6,45

11111111111111111111111111111111111111111111111111111111111111111111111
1N000000000000000000000000000000000000000000000000000000000000000000001
10111111101111111111111111110111111111100000000000000000000000000000001
10100000100000000000000000000111111111100000000000000000000000000000001
10101111111111111111111011110111111111100000000000000000000000000000111
10101000000000000000001000000111111111111111111111111111111111111111111
101010111111111111111011111101
101010100000000000000010000001
101010101111111111111010111101
100010101000000000001010000001
111010101011111111101011111101
100010100010000001001000000001
101110111110111101111011111101
100000100000100001000010000001
101111101111101111101110111101
100000001000001000000010000001
111111101011111111111010111101
100000101000000000001010000001
101111101111111111111011111101
111111111111111111111111111111
