
NO ./textures/gnawa/zelijv2.xpm
SO ./textures/gnawa/wall2_pixel.xpm
WE ./textures/gnawa/zelijv1.xpm
EA ./textures/gnawa/textured_wall.xpm

F 220,100,22
C 225,30,1

        1111111111111111111111111
        1000000000110000000000001
        1011000001110000000000011
        10010000000000000N0000001
111111111011000001110000000000001
100000000011000001110111011111111
11110111111111011100000010001
11110111111111011101010010001
11000000110101011100000010001
10000000000000001100000010001
10000000000000001101010010001
11000001110101011111010000001
11110111111101011101111010001
11111111111111111111111111111

























































































































